# Syntax Colouring Map For XMLWriter

# Data types (KEYWORD1)
XMLWriter	KEYWORD1


# Methods and Functions (KEYWORD2)
reset	KEYWORD2
setConfig	KEYWORD2

header	KEYWORD2
version	KEYWORD2
debug	KEYWORD2
comment	KEYWORD2
newLine	KEYWORD2
raw	KEYWORD2

setIndentSize	KEYWORD2
getIndentSize	KEYWORD2
incrIndent	KEYWORD2
decrIndent	KEYWORD2
indent	KEYWORD2

tagOpen	KEYWORD2
tagClose	KEYWORD2
tagStart	KEYWORD2
tagEnd	KEYWORD2

tagField	KEYWORD2
writeNode	KEYWORD2

escape	KEYWORD2
needFlush	KEYWORD2
flush	KEYWORD2


bufferIndex	KEYWORD2
bytesWritten	KEYWORD2


# Instances (KEYWORD2)

# Constants (LITERAL1)
XMLWRITER_VERSION	LITERAL1

NOMULTILINE	LITERAL1
MULTILINE	LITERAL1
NEWLINE	LITERAL1
NONEWLINE	LITERAL1
NOINDENT	LITERAL1

SLASH	LITERAL1
NOSLASH	LITERAL1

XMLWRITER_NONE	LITERAL1
XMLWRITER_COMMENT	LITERAL1
XMLWRITER_INDENT	LITERAL1
XMLWRITER_NEWLINE	LITERAL1

