# Syntax Coloring Map For BitArray

# Datatypes (KEYWORD1)
BitArray	KEYWORD1


# Methods and Functions (KEYWORD2)
begin	KEYWORD2
capacity	KEYWORD2
memory	KEYWORD2
bits	KEYWORD2
segments	KEYWORD2
getError	KEYWORD2
clear	KEYWORD2
get	KEYWORD2
set	KEYWORD2
toggle	KEYWORD2


# Constants (LITERAL1)
BITARRAY_LIB_VERSION	LITERAL1
BA_ERR	LITERAL1
BA_OK	LITERAL1
BA_NO_MEMORY_ERR	LITERAL1
BA_IDX_RANGE_ERR	LITERAL1
BA_ELEMENT_SIZE_ERR	LITERAL1
BA_SIZE_ERR	LITERAL1

