# Syntax Colouring Map For I2C_SCANNER

# Data types (KEYWORD1)
I2C_SCANNER	KEYWORD1

# Methods and Functions (KEYWORD2)
begin	KEYWORD2

getWirePortCount	KEYWORD2
setWire	KEYWORD2
getWire	KEYWORD2

softwareReset	KEYWORD2

setClock	KEYWORD2
getClock	KEYWORD2

ping	KEYWORD2
diag	KEYWORD2
pingTime	KEYWORD2
count	KEYWORD2

setWireTimeout	KEYWORD2
getWireTimeout	KEYWORD2

#if supported they get highlighted
getSDA	KEYWORD2
getSCL	KEYWORD2

getDeviceID	KEYWORD2


# Constants (LITERAL1)
I2C_SCANNER_LIB_VERSION	LITERAL1

