# Syntax Colouring Map For SHT85 temperature and humidity sensor


# Data types (KEYWORD1)
SHT	KEYWORD1
SHT30	KEYWORD1
SHT31	KEYWORD1
SHT35	KEYWORD1
SHT85	KEYWORD1


# Methods and Functions (KEYWORD2)
begin	KEYWORD2
getType	KEYWORD2

read	KEYWORD2
requestData	KEYWORD2
dataReady	KEYWORD2
readData	KEYWORD2
lastRequest	KEYWORD2

isConnected	KEYWORD2
readStatus	KEYWORD2
lastRead	KEYWORD2
reset	KEYWORD2
getError	KEYWORD2

setHeatTimeout	KEYWORD2
getHeatTimeout	KEYWORD2
heatOn	KEYWORD2
heatOff	KEYWORD2
isHeaterOn	KEYWORD2

getHumidity	KEYWORD2
getTemperature	KEYWORD2
getFahrenheit	KEYWORD2
getRawHumidity	KEYWORD2
getRawTemperature	KEYWORD2

setTemperatureOffset	KEYWORD2
getTemperatureOffset	KEYWORD2
setHumidityOffset	KEYWORD2
getHumidityOffset	KEYWORD2

GetSerialNumber	KEYWORD2


# Instances (KEYWORD2)


# Constants (LITERAL1)
SHT_LIB_VERSION	LITERAL1

SHT_DEFAULT_ADDRESS

SHT_STATUS_ALERT_PENDING	LITERAL1
SHT_STATUS_HEATER_ON	LITERAL1
SHT_STATUS_HUM_TRACK_ALERT	LITERAL1
SHT_STATUS_TEMP_TRACK_ALERT	LITERAL1
SHT_STATUS_SYSTEM_RESET	LITERAL1
SHT_STATUS_COMMAND_STATUS	LITERAL1
SHT_STATUS_WRITE_CRC_STATUS	LITERAL1

SHT_OK	LITERAL1
SHT_ERR_WRITECMD	LITERAL1
SHT_ERR_READBYTES	LITERAL1
SHT_ERR_HEATER_OFF	LITERAL1
SHT_ERR_NOT_CONNECT	LITERAL1
SHT_ERR_CRC_TEMP	LITERAL1
SHT_ERR_CRC_HUM	LITERAL1
SHT_ERR_CRC_STATUS	LITERAL1
SHT_ERR_HEATER_COOLDOWN	LITERAL1
SHT_ERR_HEATER_ON	LITERAL1

