# Syntax Colouring Map For SHEX


# Data types (KEYWORD1)
SHEX	KEYWORD1
SHEXA	KEYWORD1


# Methods and Functions (KEYWORD2)
reset	KEYWORD2
write	KEYWORD2

setHEX	KEYWORD2
getHex	KEYWORD2

setBytesPerLine	KEYWORD2
getBytesPerLine	KEYWORD2

setSeparator	KEYWORD2
getSeparator	KEYWORD2

setCountDigits	KEYWORD2
getCountDigits	KEYWORD2

restartOutput	KEYWORD2
getCounter	KEYWORD2

setVTAB	KEYWORD2
getVTAB	KEYWORD2


# Constants (LITERAL1)
SHEX_LIB_VERSION	LITERAL1

SHEX_DEFAULT_LENGTH	LITERAL1
SHEX_MAX_LENGTH	LITERAL1
SHEX_MIN_LENGTH	LITERAL1

SHEX_COUNTER_DIGITS	LITERAL1
SHEX_DEFAULT_VTAB	LITERAL1

