# Syntax Coloring Map For I2C_EEPROM


# Datatypes (KEYWORD1)
I2C_eeprom	KEYWORD1
I2C_eeprom_cyclic_store	KEYWORD1


# Methods and Functions (KEYWORD2)
# Common
begin	KEYWORD2
isConnected	KEYWORD2


# I2C_eeprom
readByte	KEYWORD2
writeByte	KEYWORD2
setBlock	KEYWORD2
readBlock	KEYWORD2
writeBlock	KEYWORD2
determineSize	KEYWORD2
updateByte	KEYWORD2
getDeviceSize	KEYWORD2
getPageSize	KEYWORD2
getLastWrite	KEYWORD2


# I2C_eeprom_cyclic_store
format	KEYWORD2
read	KEYWORD2
write	KEYWORD2
getMetrics	KEYWORD2

# Constants (LITERAL1)
