# Syntax Colouring Map For rotaryDecoderSwitch


# Data types (KEYWORD1)
rotaryDecoderSwitch	KEYWORD1


# Methods and Functions (KEYWORD2)
begin	KEYWORD2
isConnected	KEYWORD2

readInitialState	KEYWORD2
checkChange	KEYWORD2
update	KEYWORD2
updateSingle	KEYWORD2

getValue	KEYWORD2
setValue	KEYWORD2
getKeyPressed	KEYWORD2

read1	KEYWORD2
write1	KEYWORD2
read8	KEYWORD2
write8	KEYWORD2

getLastPosition	KEYWORD2


# Constants (LITERAL1)
ROTARY_DECODER_SWITCH_LIB_VERSION	LITERAL1
