# Syntax Colouring Map For HeartBeat

# Data types (KEYWORD1)
HeartBeat	KEYWORD1
HeartBeatDiag	KEYWORD1
HeartBeatSL	KEYWORD1


# Methods and Functions (KEYWORD2)
begin	KEYWORD2
setFrequency	KEYWORD2
setDutyCycle	KEYWORD2
getFrequency	KEYWORD2
getDutyCycle	KEYWORD2

enable	KEYWORD2
disable	KEYWORD2

beat	KEYWORD2
getState	KEYWORD2

# Methods from derived class
code	KEYWORD2
codeOff	KEYWORD2
codeCompleted	KEYWORD2

# Constants (LITERAL1)
HEARTBEAT_LIB_VERSION	LITERAL1
