# Syntax Colouring Map For SparseMatrix

# Data types (KEYWORD1)
SparseMatrix	KEYWORD1

# Methods and Functions (KEYWORD2)
size	KEYWORD2
count	KEYWORD2
sum	KEYWORD2
clear	KEYWORD2

get	KEYWORD2
set	KEYWORD2
add	KEYWORD2
boundingBox	KEYWORD2
boundingBoxX	KEYWORD2
boundingBoxY	KEYWORD2

first	KEYWORD2
next	KEYWORD2
prev	KEYWORD2
last	KEYWORD2


# Constants (LITERAL1)
SPARSEMATRIX_LIB_VERSION	LITERAL1
SPARSEMATRIX_MAX_SIZE	LITERAL1

