# Syntax Colouring Map For BoolArray

# Data types (KEYWORD1)
BoolArray	KEYWORD1
BoolArray32	KEYWORD1


# Methods and Functions (KEYWORD2)
begin	KEYWORD2
size	KEYWORD2
memory	KEYWORD2

setAll	KEYWORD2
clear	KEYWORD2
get	KEYWORD2
set	KEYWORD2
toggle	KEYWORD2


# Constants (LITERAL1)
BOOLARRAY_LIB_VERSION	LITERAL1

BOOLARRAY_MAXSIZE	LITERAL1

BOOLARRAY_OK	LITERAL1
BOOLARRAY_ERROR	LITERAL1
BOOLARRAY_SIZE_ERROR	LITERAL1
BOOLARRAY_INIT_ERROR	LITERAL1
